#############################################################
#___________________________________________________________#
#___________________________________________________________#
#___________________________________________________________#
#____________________0______________________________________#
#___________________________________________________________#
#___________________________________________________________#
#___________________________________________________________#
#_________________________________0_________________________#
#___________________________________________________________#
#___________________________________________________________#
#_____________________________________________00000000______#
#___________________________________________________________#
#___________________________________________________________#
#___________________________________________________________#
#___________________________________________________________#
#___________________________________________________________#
#___________________0000____________________________________#
#___________________________________________________________#
#___________________________________________________________#
#___________________________________________________________#
#_____0_____________________________________________________#
#_____________________00____________________________________#
#___________________________________________________________#
#___________________________________________________________#
#___________________________________________________________#
#___________________________________________________________#
#___________________________________________________________#
#___________________________________________________________#
#___________________________________________________________#
#___________________________________________________________#
#___________________________________________________________#
#___________________________________________________________#
#___________________________________________________________#
#___________________________________________________________#
#___________________________________________________________#
#_________________________0_________________________________#
#____________________________________________________0______#
#___________________________________________________________#
#___________________________________________________________#
#___________________________________________________________#
#############################################################