0,46,46,46,46,46,46,46,46,46,46,46,2
18,61,61,61,61,61,61,61,61,61,61,61,18
18,34,34,34,34,34,34,34,34,34,34,34,18
18,34,34,34,34,34,34,34,34,34,34,34,18
18,34,34,34,34,34,34,34,34,34,34,34,18
18,34,34,34,34,34,34,34,34,34,34,34,18
18,34,34,34,34,34,34,34,34,34,34,34,18
18,34,34,34,34,34,34,34,34,34,34,34,18
18,34,34,34,34,34,34,34,34,34,34,34,18
30,46,46,46,46,46,46,46,46,46,46,46,32
