0,46,46,46,46,46,46,46,46,32,-1,30,46,46,46,46,46,46,46,46,2
18,60,60,60,60,60,60,60,60,60,-1,60,60,60,60,60,60,60,60,60,18
18,49,49,49,49,49,49,49,49,49,49,49,49,49,49,49,49,49,49,49,18
18,49,49,49,49,49,49,49,49,49,49,49,49,49,49,49,49,49,49,49,18
18,49,49,49,49,49,49,49,49,49,49,49,49,49,49,49,49,49,49,49,18
18,49,49,49,49,49,49,49,49,49,49,49,49,49,49,49,49,49,49,49,18
18,49,49,49,49,49,49,49,49,49,49,49,49,49,49,49,49,49,49,49,18
18,49,49,49,49,49,49,49,49,49,49,49,49,49,49,49,49,49,49,49,18
18,49,49,49,49,49,49,49,49,49,49,49,49,49,49,49,49,49,49,49,18
18,49,49,49,49,49,49,49,49,49,49,49,49,49,49,49,49,49,49,49,18
30,46,46,46,46,46,46,46,46,46,46,46,46,46,46,46,46,46,46,46,32
